!SIL SIL
กระโดด	kr a d oo t^
กลับ	kl a p^
กิน	k i n^
กู๊ดไนท์	k uu o t^ n^
ก้าว	k aa w^
ขว้าง	khw aa ng^
ขอ	kh @@
ขี่	kh ii
ขี่่	kh ii xx
ขึ้น	kh v n^
ข้า	kh aa
ข้าม	kh aa m^
คราฟ	khr aa f^
จะ	c a
จุด	c u t^
ชัท	ch a t^
ชัฟเฟิล	ch a f i n^
ชาร์จ	ch aa t^
ดัง	d a ng^
ดาบ	d aa p^
ดู	d uu
ตก	t o k^
ตักน้ำ	t a k^ n aa m^
ตักลาวา	t a k^ l aa w aa
ตี	t ii
ถือ	th vv
ทำไม	th a m^ m a j^
ทิ้ง	th i ng^
ธนู	th a n uu
นักร้อง	n a k^ r @@ ng^
ประตู	pr a t uu
ปล่อย	pl @ j^
ปา	p aa
ปิด	p i t^
ป้องกัน	p @ ng^ k a n^
พอ	ph @@
พอส	ph @@ t^
ฟื้น	f vv n^
ฟ้า	f aa
ย่อ	j @@
รีเซท	r ii s t^
ลง	l o ng^
ลด	l o t^
ลบ	l o p^
ลา	l aa
วาง	w aa ng^
วาร์ป	w aa p^
วิง	w i ng^
วิ่ง	w i ng^
ว้าย	w aa j^
สต็อป	s a t @ p^
สร้าง	s aa ng^
สุ่ม	s u m^
หมุน	m u n^
หมุุน	m u u n^
หยุด	j u t^
ห้าม	h aa m^
อยาก	j aa k^
อิ่ม	z i m^
อีก	z ii k^
เงียบ	ng iia p^
เงียบๆ	ng iia p^ ng^
เดิน	d qq n^
เบา	b a w^
เปลี่ยน	pl iia n^
เปิด	p qq t^
เผา	ph a w^
เพลง	phl ee ng^
เพิ่ม	ph qq m^
เริ่ม	r qq m^
เลิก	l qq k^
เลือก	l vva k^
เล่น	l e n^
เอา	z a w^
แปลง	pl xx ng^
แรนดอม	r xx n^ d @ m^
โกวาจี	k oo w aa c ii
โจมตี	c oo m^ t ii
โอม	z oo m^
โอ๊ย	z e qq j^
ใส่	s a j^
ให้อาหาร	h a j^ z aa h aa n^
ไม่	m a j^
