ประชุม	pr a ch u m^
วันนี้	w a n^ n ii
นั่ง	n a ng^
ทำงาน	th a m^ ng aa n^
ที่ไหน	th ii n a j^
ดี	d ii
ขั้น	kh a n^
ตอน	t @@ n^
ถัด	th a t^
ไป	p a j^
พรุ่งนี้	phr u ng^ n ii
หยุด	j u t^
งาน	ng aa n^
อาหาร	z aa h aa n^
ไทย	th a j^
ร้าน	r aa n^
ดัง	d a ng^
เรา	r a w^
มี	m ii
นัด	n a t^
กี่	k ii
โมง	m oo ng^
ถาม	th aa m^
ตาราง	t aa r aa ng^
นัด	n a t^
ร้าน	r aa n^
อร่อย	z a r @ j^
ใน	n a j^
จุฬา	c u l aa
วันนี้	w a n^ n ii
ออก	z @@ k^
สาย	s aa j^
พูด	ph uu t^
ถอย	th @ j^
หลัง	l a ng^
