!SIL SIL
กี่	k ii
ขั้น	kh a n^
งาน	ng aa n^
จุฬา	c u l aa
ดัง	d a ng^
ดี	d ii
ตอน	t @@ n^
ตาราง	t aa r aa ng^
ถอย	th @ j^
ถัด	th a t^
ถาม	th aa m^
ทำงาน	th a m^ ng aa n^
ที่ไหน	th ii n a j^
นัด	n a t^
นั่ง	n a ng^
ประชุม	pr a ch u m^
พรุ่งนี้	phr u ng^ n ii
พูด	ph uu t^
มี	m ii
ร้าน	r aa n^
วันนี้	w a n^ n ii
สาย	s aa j^
หยุด	j u t^
หลัง	l a ng^
อร่อย	z a r @ j^
ออก	z @@ k^
อาหาร	z aa h aa n^
เรา	r a w^
โมง	m oo ng^
ใน	n a j^
ไทย	th a j^
ไป	p a j^
